F 31,99,112            

SO textures/south.xpm      


C 17,16,38                

NO textures/north.xpm
WE textures/west.xpm

EA textures/east.xpm


11111111111
10000000001
11111111111

111111111111111  1111111111111111111111111111111111111111111
100000000000001  1000000000000000000000000000000000001
111000000000001  100000001D10000000000000000000000011
  1000000000001  1000000000000000000000000000000000011
  10000000000011110000000000000000000000000000000000101
  1000000000000000000000000000000000000000000000000011
111000000000000111000111100011110001110000000000000011111
10000000000000000100000010000001000001000000000000011
10001D100000000001000111100011110000100000000000001
100000000000000001000000100000010000100000000000001
100000000000000111100111100011110000100000000000001
10000000S0000000000000000000000000000000000000000001
10000001D1000000000000000000000000000000000000000001
1111111111111111111111111111111111111111111111111111

11111111111111111
10000000000000001
1000000000000001
1111111111111111