F 31,99,112            

SO textures/south.xpm      


C 17,16,38                

NO textures/north.xpm
WE textures/west.xpm

EA textures/east.xpm





















1111111111111111
11000001D1100001
1100000000010001
11000001000N0001
1111111111111111
1111111111111111