F 31,99,112            

SO ../textures/south.xpm      


C 17,16,38                

NO ../textures/north.xpm
WE ../textures/west.xpm

EA ../textures/east.xpm


111111111111111  11111111111111111111111111111
  10000000000011110000000000000000000000000001
  10000000000000000000000000000000000000000001
1110000000000001110001111000111100011100000001
1000000000000000010000001000000100000100000001
1000000000000000010001111000111100001000000001
1000000000000000010000001000000100001000000001
1000000000000001111001111000111100001000000001
10000000S0000000000000000000000000000000000001
1111111111111111111111111111111111111111111111

11111111111111111
10000000000000001
1000000000000001
1111111111111111